///////////////////
/                 /
/                 /
/        @        /
/                 /
/                 /
/                 /
////////    ///////
/                 /
/                 /
/                 /
/                 /
/                 /
/                 /
/////////#/////////